1111111111111111
1000000100000001
10P00CC0101C1111
111C000000110001
1110000C00110E01
1111000000110001
1111111111111111