111111111111111111111111111111111111111111111111111
100000000100000010000000100000000000000000000000010
100P000C0100000100000000010000000000000000000000000
100001000100001000C0000C001000000011111111000001001
1111110C0100010000000100000100001000000001000100001
1000000C010010000C001010000010001000000000010000101
10C0C0C00101000000010001000C01011000001000000001001
100001111110000000100000100000100000010100000010001
1010000001000C000100010C010000000000100000000100001
10C1100001000000100011000000C0100001000000001000001
100000000000C000100000100C0001000010100000010000001
111111111100000010000001000010000100000000100000001
111111111111101111111111100000111111111111111111111
11111111111110111111111111110C001111111111111111111
100000000100000010000000100000000000000000000000001
100000000100000100000000000000000C00000000000000001
10000100000000000C000000001000000011111111100000001
111111000100010000000100000100E00100000001000000001
111111111111111111111111111111111111111111111111111
