11111111111111111111111111111111111111111111111111111111111111111111111111111111111
1000000001000000100000001000000000000000000000000C000000000000000000000000000010011
100P000C010000010000000001000000000000000000000000000000000000000000000000000100011
10000100010000100000000000100000001111111100000100000000001000000000001000001000001
1111110C0100010000000100000100E0010000000010001000000000000100001000000100000000001
1000000C010010000000101000001000100000000001010000000100000010010000000010100000001
10C0C0C0010100000001000100000101100000100000100000001000000001100000000001000000001
10000111111000000010000010000010000001010000010000010000000001000000000010000000001
11100000010000000100010c01000000000010000000000000100000000010000000000100000100001
10C11000010000001000110000000010000100000100000001000000000100000000001000000010001
10000000000000001000001000000100001000000100000010000000001000000000010000000001001
11111111110000001000000100001000010000000000000100000000010000000000100000000000101
11111111111111111111111111111111111111111111111111111111111111111111111111111111111
