1111111111111111111111111111111111
1000000000000000000000000000000001
1000000P00000000C00000000C00000001
11111111111000C00000000C0000000001
10000000P0000000000000100000000C01
100000C00000001000000E000000000111
1111111111111111111111111111111111