1111111111111111
1000000100000001
10P00CC0111C1111
111CE00011111111
1111111111111111