1111111111111111
1000000100000001
10P00CC0101C1101
111C0000001101E1
1110000C0011011
1111000000110001
1111111111111111